              # #####
              #.....#
              #.....#
              #.....#
              #.....#
              #.....#
              # #####
          ...... 
       ### ###
       .......
       .......
       .......
       .......
       .......
       ### ###
          ........
              ### ###
              #.....#
              #.....#
              #.....#
              #.....#
              #.....#
              ###.###
