         ................ 
         .    #######
         .    #.....#
         .    #.....#
         .    #.....#
         .    #.....#
         .    #.....#
         .    #######
         .
       ##.####
       #.....#
       #.....#
       #.....#
       #.....#
       #.....#
       ## ####
         .........
              ### ###
              #.....#
              #.....#
              #.....#
              #.....#
              #.....#
              ### ###
