       # #####
       #.....#
       #.....#
       #.....#
       #.....#
       #.....#
       #.#####
        ...................
                     #####.#
                     #.....#
                     #.....#
                     #.....#
                     #.....#
                     #.....#
                     ##### #
                         ..
                     #### ##
                     #.....#
                     #.....#
                     #.....#
                     #.....#
                     #.....#
                     ####.##
               ...........
              #.#####
              .......
              .......
              .......
              .......
              .......
              # #####
               .........
                     ## ####
                     .......
                     .......
                     .......
                     .......
                     .......
                     ## ####
