[38;2;187;127;118m  [8;46;103t
[38;2;187;127;118m  ]11;#252424\
[H[2J[3J[38;2;187;127;118m          / \      / \
        /   \    /   \
     ##/_____\##/_____\##
     # |     |  |     | #
     # | +-+ |  | +-+ | #                ######################
     # +_|_|_+  +_|_|_+ #                #                    #
     ####################                ######################
###############################     ######         _          #####     ###############################
#_____________________________#     #____#________| |_________#___#     #_____________________________#
#      .       .       .      #     #     .     .     .     .     #     #     T     T     T     T     #
#  .       .       .       .  #######  .     .     .     .     .  #######  .     T     T     T     .  #
#      .       .       .      #_____#     .     .     .     .     #_____#     .     .     .     .     #
#  .       .       .       .  ||---||  .     .     .     .     .  ||---||  .     .     .     .     T  #
#      .       .       .      ||---||      .     .     .     .    ||---||     .     .     .     .     #
#  .       .       .       .  #######  .     .     .     .     .  #######  .     T     T     T     .  #
#      .       .       .      #_____#     .     .     .     .     #_____#     T     T     T     T     #
#  .       .       .       .  #     #  .     .     .     .     .  #     #  .     T     T     T     .  #
#      .       .       .      #     #     .     .     .     .     #     #                             #
###############################     ############+=====+############     ###############################
#_____________________________#     #__________#+=====+#__________#     #_____________________________#
                                               #-------#
                                    ############+=====+############
                                    #__________#+=====+#__________#
                  ################# #     @     .     .     .     # #################
                  #   +-------+   # #  .     .     .     .     .  # #               #
                  #  /         \  # #     .     .     .     .     # #      +--+     #
                  # /___________\ # #  .     .     .     .     .  # #       |Q|     #
                  # | []  _  [] | # #     .     .     .     .     # #       | |     #
                  # |____|#|____| # #  .     .     .     .     .  # #       |=|     #
                  #               # #     .     .     .     .     # #               #
                  #               # #                             # #################
                  ################# ############+------+###########
                                    #__________#+------+#_________#
 [0m
[8;23;80t
]11;#000000\
[H[2J[3J