              #######
              .......
              .......
              .......
              .......
              .......
              #######
 
                     #### ##
                     .......
                     .......
                     .......
                     .......
                     .......
                     #### ##
 
                     ##### #
                     #.....#
                     #.....#
                     #.....#
                     #.....#
                     #.....#
                     ##### #
 
